type octile
height 29
width 29
map
TTTTTTTTTTTTTTTTTTTTTTTTTTTTT
T...........................T
T..TTT.TTT.TTT.TTT.TTT.TTT..T
T...........................T
T..TTT.TTT.TTT.TTT.TTT.TTT..T
T...........................T
T..TTT.TTT.TTT.TTT.TTT.TTT..T
T...........................T
T..TTT.TTT.TTT.TTT.TTT.TTT..T
T...........................T
T..TTT.TTT.TTT.TTT.TTT.TTT..T
T...........................T
T..TTT.TTT.TTT.TTT.TTT.TTT..T
T...........................T
T..TTT.TTT.TTT.TTT.TTT.TTT..T
T...........................T
T..TTT.TTT.TTT.TTT.TTT.TTT..T
T...........................T
T..TTT.TTT.TTT.TTT.TTT.TTT..T
T...........................T
T..TTT.TTT.TTT.TTT.TTT.TTT..T
T...........................T
T..TTT.TTT.TTT.TTT.TTT.TTT..T
T...........................T
T..TTT.TTT.TTT.TTT.TTT.TTT..T
T...........................T
T..TTT.TTT.TTT.TTT.TTT.TTT..T
T...........................T
TTTTTTTTTTTTTTTTTTTTTTTTTTTTT
